awkward: vụng về
be nothing but a trap: k khác j một cái bẫy
blantantly: ngang nhiên
breath-taking: hấp dẫn/ ngoạn mục
capivating: quyến rũ
careless-> carelessness
chances are: rất có thể
climax: cực điểm
clutter: sự bừa bộn, lộn xộn
condemn: lên án
content >< discontent: hài lòng - bất mãn
contradict: mâu thuẫn
counsel: cố vấn
cuisine: ẩm thực (kwəˈzēn)
curated: được tuyển chọn
decent: tử tế, đứng đắn. (n) decency
decentralized: phi tập trung
deficiency: sự thiếu hụt
delightful: thú vị
diagnose: chuẩn đoán
do whatever it is that you want to do
effusive:(əˈfyo͞osiv): nồng nhiệt, dạt dào
exquisite:(ekˈskwizət): tinh tế, thanh tú
fascinate: mê hoặc
fraud detection: phát hiện gian lận
freedom of expression: tự do ngôn luận
genuine: sincere  (ˈjenyo͞oən)
inevitability:(iˌnevədəˈbilədē): tất yếu
inferiority: sự tự ti
infrustructure: cơ sở hạ tầng
inhale><exhale
inhibit: cản trở, ức chế
integrate = incorporate: tích hợp
interrogate: chất vấn
leverage: tận dụng
literally:(ˈlidərəlē): theo nghĩa đen
live with all your might: sống hết mình
objectively: khách quan
open-ended: endless
persistence: bền bỉ
pop out: appear suddenly 
predetermine: định trước
rather than: instead of
reach out: tiếp cận
regardless of: bất kể
sarcastic: mỉa mai
scalable: có thể mở rộng
seamlessly: liền mạch
self-esteem: tự trọng  
self-sufficient: tự chủ
severe: dữ dội
soon enough: chẳng bao lâu nữa
sparkling: lấp lánh
take away the key learning: rút ra bài học
tentative: dự tính  (ˈten(t)ədiv)
to put it another way = in other words >< on the other hand 
tricky: hard to do something
underlying: cơ bản
unwind: tháo ra, thư giãn
utter gratitude: biết ơn tột độ
versatile: linh hoạt
vibrant: sôi động
withstand: chống lại
settle: ổn định
synchronize: đồng bộ hóa
excess: dư thừa, thặng dư
redeem: chuộc lại/ đổi
retreat: rút lui
requirements set forth: các yêu cầu đặt ra
biased >< unbiased: thiên vị
tactic: chiến thuật
pirate: cướp biển
paralyzed: bị tê liệt
raft: cái bè
subtle: tế nhị
neat: gọn gàng
outraged: anger, Strong reaction: tức giận
soundproof: cách âm